
stripedorange|vibrantgreen|plaidyellow|drabmagenta
darkfuchsia|wavyindigo|stripedlime
clearmaroon|cleargold|brightsalmon|wavytomato
fadedtan|dimbrown
wavyolive|fadedgray|poshbrown|stripedcyan
lightplum|vibrantplum
vibrantcyan|dottedgold|brightindigo|wavylime|clearplum
vibrantbeige|wavysilver|shinyindigo|wavyaqua|mirroredcyan
lighttomato|mutedgreen|stripedtomato|fadedaqua|mutedsalmon
drabwhite|fadedbeige|lightpurple|stripedwhite|mutedcyan
fadedpurple|poshlime
stripedviolet|dimbronze|fadedplum
paleteal|shinysalmon|lighttomato|dimcoral
dulllime|brighttomato|dimmagenta|brightcyan|darkteal
dimsalmon|darkchartreuse
fadedteal|shinycoral|darkturquoise|wavyblack
darkgreen|vibrantgreen|clearblue
dimblack|vibrantbronze
lightyellow|fadedsalmon|mutedaqua
drabbrown|cleargreen|paleaqua
dottedtomato|vibrantpurple|vibranttomato|clearlime|dimgold
fadedorange|palebrown
lightblack|stripedsilver|dimbrown|brightcyan|stripedlime
plaidturquoise|mutedfuchsia|dullviolet
lightlime|clearlime|wavyblue
plaidblue|dottedblue|lightbrown|poshteal
vibrantmaroon|brightlavender
lightorange|wavymagenta|clearorange|stripedsilver
brightbeige|plaidred|dullaqua|brightfuchsia
stripedcrimson|fadedmaroon|dullchartreuse|mirroredred|clearorange
poshsilver|paleplum|lightsalmon|lightpurple
dullwhite|darkwhite
brightlime|clearindigo|vibrantgreen
brightcrimson|lightlime
dulllavender|vibrantmagenta
palepurplenoother
vibrantcoral|brightcyan|brighttomato
poshsalmon|vibrantmagenta|dullaqua
dullblack|dottedblack
shinysalmon|fadedplum|clearlavender|lightcrimson|lightgray
vibrantred|dimbronze|stripedindigo|vibrantsilver
plaidbeige|poshpurple|palebronze|dottedwhite
stripedbronze|wavysalmon
shinylavender|shinysalmon|brightsalmon|poshfuchsia
plaidchartreuse|vibrantbronze|dullchartreuse|wavytomato
brightchartreusenoother
wavywhite|dimblue|fadedsilver|shinysilver|shinybeige
drabbeige|wavytomato
mirroredteal|mutedlavender|dullchartreuse
dottedbronze|clearmagenta|mutedsilver|mutedcyan
dimred|shinyfuchsia|dottedwhite
shinycrimson|dullwhite|vibrantmaroon
wavyplum|lightcrimson|cleargreen
fadedolive|poshcyan
mirroredgold|stripedgold
dimcyan|shinygreen|wavyblue|mirroredlime|darkplum
vibrantorange|mirroredlime|brightchartreuse|palecrimson|mutedbeige
palebeige|dullolive
poshlavender|fadedred|wavymaroon
plaidteal|dullblack|mutedtan
wavyred|poshsalmon|lightblack|drabolive|drabbeige
drabmaroon|brightyellow
cleartan|lightyellow|mirroredindigo|dottedolive|dimmagenta
stripedturquoise|poshcyan|clearcrimson
poshturquoise|brightbronze|brightorange
darkturquoise|poshyellow|dullred|plaidsilver|brighttomato
poshgreen|wavybronze
mutedgreen|brightfuchsia|mutedgold|lightorange
drabsalmon|lightblack
dottedcoral|palechartreuse
darkyellow|fadedred|palebrown
mutedteal|cleargold|stripedtomato|darkteal
brightsilver|brightgray
drabchartreuse|paleteal
mutedplum|poshwhite|brightred|stripedgold
darkbronze|brightcyan|dimbeige|palebronze|lightgray
dimfuchsia|darkblack|mirroredchartreuse|fadedgray
fadedbrown|wavywhite|dullviolet
brightgreen|vibrantfuchsia|shinywhite|mirroredblue|poshaqua
dottedturquoise|shinybeige|wavyblue
wavychartreuse|darkplum
shinyorange|clearorange|darkcoral|brightteal|dottedbrown
shinygray|dullolive|mutedaqua
clearblue|brightsalmon|shinygold
vibrantolive|brightsalmon|mutedgreen|wavyolive
mutedgold|stripedplum|dullviolet|shinygreen
plaidaqua|shinypurple|wavylime|stripedviolet|clearmagenta
dimbronzenoother
vibrantturquoise|wavyplum
lightteal|clearplum|drabcrimson
lightcoral|drabviolet|lightyellow|fadedmaroon
brightcyan|dimcrimson|stripedplum|mutedgold
wavypurple|vibranttomato|dullbronze|dimcoral
dulltan|mutedfuchsia
brightwhite|paleblue
clearplum|mutedlavender|fadedaqua|fadedplum|dullindigo
vibranttomato|poshpurple|mirroredlime|vibrantturquoise|clearmaroon
mutedtan|dimmagenta|dottedgray|plaidorange|palegreen
darkbrown|stripedplum|mirroredtomato|fadedplum|lightyellow
stripedyellow|mutedindigo|brightblack|clearlime|stripedwhite
poshblack|mirroredtomato|poshgray
wavyblack|paleorange|poshviolet|dottedwhite|fadedred
mutedindigo|brightfuchsia|mutedlavender
brightcoral|poshchartreuse|shinygold
poshtomato|lightviolet|mirroredolive
poshcyan|mirroredchartreuse|dottedblack|vibrantgray
palesilver|lightfuchsia|darkred
plaidindigo|plaidred|stripedcyan|mutedsilver|wavymagenta
dottedindigo|mirroredmagenta|plaidgold|darkcoral|vibrantsilver
lightchartreuse|shinyblue|drabcoral|drabturquoise
paletomato|wavyviolet|dottedtan|drabbrown
mutedchartreuse|dimsilver|dimchartreuse|stripedgreen|dimmagenta
dullaqua|palecrimson|drabaqua|drabmagenta|cleargold
darklime|lighttan
darkorange|draborange
fadedblack|dottedchartreuse|wavysilver|plaidolive|paleblue
dullpurple|cleargold|wavylavender
dottedgold|palepurple|darkolive|wavybeige|mirroredaqua
palebronze|shinytomato|vibrantturquoise
brightaqua|paleteal|fadedcoral|clearolive
fadedbeige|wavyyellow|palelavender|vibrantcoral
drabturquoise|shinytomato|clearlavender|draborange
lightmaroon|poshbronze|dottedsilver|plaidsilver|mutedteal
poshmaroon|mirroredmaroon|poshblack|fadedsalmon|poshgray
brightred|vibrantsalmon
vibrantpurple|fadedviolet
vibrantcrimson|plaidyellow|dottedyellow|paletan
dimgreen|fadedplum|poshturquoise|mutedaqua
stripedgray|stripedfuchsia
lightsalmon|dimcoral|poshbrown|shinygreen|stripedbeige
brightviolet|dimmaroon|darktan|drabpurple|mutedcyan
dottedchartreuse|poshlime
drabsilver|dimcoral|palechartreuse|lightsalmon
mirroredlime|lightorange|clearorange|wavyplum
mutedviolet|fadedsilver|poshred|drabaqua
dullsalmon|dullmaroon|mirroredred
poshaqua|dimturquoise|drabgreen|stripedred
mutedwhite|lightyellow|paleyellow|dullolive
wavycoral|wavylime|fadedpurple|poshgray|darktomato
darksilver|dullchartreuse|dullviolet
dottedplum|mirroredviolet|dimcrimson|mirroredfuchsia|lighttan
mirroredpurple|mutedlime|mirroredteal|lighttomato
drabyellow|drabviolet|stripedorange
stripedteal|mutedcyan|lightfuchsia
drabred|fadedcoral|brightcrimson
paleorange|dullchartreuse|clearorange
poshgold|fadedgray|stripedindigo
lightcrimsonnoother
mutedred|dimgray
clearcyan|fadedsalmon|lightbrown|mutedpurple|stripedbeige
plaidcyan|clearyellow|shinygray|palegreen|poshaqua
clearbrown|fadedlime|dullbronze|clearbronze
lighttan|lightbronze|draborange
dimindigo|shinyfuchsia
mutedblack|palefuchsia|brightmaroon|stripedlavender
fadedgray|wavyplum|wavymagenta|clearlavender
mirroredmagenta|clearblue
darkaqua|vibrantblue|paleaqua
dimlavender|clearmagenta|drabblue
brightgray|dullolive|plaidlime|clearblue
poshteal|paleyellow
paleplum|brightfuchsia|dottedwhite|palecrimson
mirroredbronze|fadedyellow
dullplum|shinycoral|poshturquoise|mutedteal
plaidsilver|vibrantblack|dullolive
dullviolet|vibrantmagenta|fadedsalmon|mirroredaqua|lightcrimson
dimyellow|clearcoral|stripedwhite|clearmaroon
draborange|dullwhite|plaidmagenta|dulllavender|dimcyan
wavymaroon|dullviolet|palebrown|vibrantmagenta|mirroredaqua
wavyturquoise|wavycrimson|poshplum|fadedturquoise|stripedcyan
clearyellow|fadedpurple|plaidlime|clearviolet|drabmagenta
mutedcrimson|vibrantorange
drabviolet|palelavender|lightyellow
dullcyan|dimcoral|poshorange|stripedbeige
shinyfuchsia|brightlime|mutedaqua|darkteal|fadedindigo
palechartreuse|darkplum|cleargold|wavyblue|dimcoral
dimorange|vibrantcoral|cleargold
shinytan|plaidtan
dullbronze|dottedlavender|wavyplum
mutedbronze|stripedwhite
wavymagenta|poshlime|wavyplum|brightchartreuse
mutedcyan|paleyellow|wavymaroon|shinygold
shinybeige|poshchartreuse|mutedindigo|wavyplum
vibrantbrown|shinygreen|palepurple|poshgray
dimblue|clearsilver|mutedblue|clearlavender
poshchartreuse|wavymagenta
dimmagenta|fadedcoral
plaidcoral|drabgray|darkorange|dimcyan
dimcoral|shinysalmon|wavyplum|lightyellow|lightpurple
clearviolet|plaidolive|mirroredviolet|mutedlavender|clearindigo
stripedcoral|dimfuchsia|vibrantyellow|vibrantplum|mirroredturquoise
stripedgold|vibrantblue|paleblue|drabbeige|dottedolive
darkbeige|wavygray
plaidred|fadedgray|mutedolive|darksilver
darkpurple|clearmaroon|darkgreen
dullyellow|vibrantwhite|dullindigo|dottedteal
fadedmagenta|darkviolet|lightindigo
palegreen|stripedfuchsia
fadedblue|palechartreuse|plaidindigo|poshfuchsia
dimbrown|dimmagenta
paleturquoise|brightsalmon|wavyyellow
darkcoral|fadedbeige|poshgold|mutedcyan|dimlime
stripedtan|vibrantbro
